0000111111100000
0001000000010000
0001010001010000
0001000000010000
0001001111010000
0000001001000000
0000011101100000
0000111011110000
0000111100111000
0001110010011100
0011100010001100
0011001101100110
0111011111110110
0111011111110110
1111001111001111
1111100111001111
