0011111111111000
0110000000011000
0100100001001100
0100000000000010
0100001110000110
0110000100001100
0011000000011000
0001111111110000
0000000111000100
0011101111001110
0001111111011100
0000111111111000
0000011111110000
0000111111100000
0000111111111000
0000111111111110
