0000111111110000
0001100000011100
0001001101100110
0001000000000011
0001000000000001
0001100111111111
1111111111000000
0111111011000000
0000110001111100
0000100000000110
0000100110110110
0000101111111010
0000110111110110
0000011011101100
0000001111111000
0000000000000000
