0000000000000000
0000000110000000
0000001001000000
0000001001000000
0000000110000000
0000000110000000
0000001001000000
0000001001000000
0000001001000000
0000001001000000
0000000111000000
0000000110000000
0000000110000000
0000000110000000
0000000110000000
0000001111000000
