0000000000000000
0000000110000000
0000001001000000
0001001001000000
0001000110000000
0001001011000000
0001111111000000
0001001001000000
0001001001000000
0001001001000000
0001000110000000
0001000110000000
0000000110000000
0000000110000000
0000000110000000
0000001111000000
