0000000000000000
0111111111111110
0100000000000010
0100011001100010
0100111001110010
0101111001111010
0101110000111010
0100000110000010
0100000110000010
0100000000000010
0100000110000010
0100001111000010
0100011111100010
0100011111100010
0100000000000010
0111111111111110
