0000000110000000
0000001111000000
0000011001100000
0000110000110000
0001100000010000
0001001011011000
0011001001001100
0010000000000100
0010000000000100
0010000000000100
0011001100001100
0001001100001000
0001000100001000
0001000000011000
0000111111110000
0000000000000000
