0000100000111000
0001110001111100
0001110001111110
0011111001111110
0011111001111110
0001110000011000
0000000000111100
0000111111111100
0000011111111100
0000000000111100
0000000000111100
0000000000011000
0000000000011000
0000000000011000
0000000000011000
0000000000011000
