0000000000000000
0000000000000000
0000000100000000
0000001010000000
0000000100000000
0011111111111110
0100100000001001
0101100000001101
0101100000001101
0101100000010101
0010010000010101
0100010000101001
0011101111101110
0000001010100000
0000010100100000
0000111111100000
