0000000000000000
0000000000000000
0000000000000000
0000000000000000
0000000000000000
0000000000000000
0000000000000000
0000001111100000
0000001000010000
0000010000001000
0000101001001000
0001000000000100
0110000110000010
0100000000000001
0111111111111111
0000000000000000
