000000000100000
000000000010000
000000000011000
000000000100100
000000000101100
000000001001000
000000001001000
000000001000110
000000010000001
000000001000001
000000000111110
000000000000000
000000000000000
000000000000000
000000000000000
000000000000000