0000000000000000
0000000011000000
0000000111110000
0000000101101000
0000001100101000
0001111111111000
0001011111110000
0000111011000000
0000011111100000
0000000011100000
0000000011110000
0000000100011000
0000000111111000
0000000010100000
0000000100100000
0000001101000000
