0011000000110000
0001000000100000
0001001111100000
0001111011100001
0001100000110011
1111010001010110
0011000000011100
0010001110001000
0011001110001000
0001000000011000
0001110000110000
0011011011100000
0010001110110000
0010000000001100
0110000000000111
0100000000000001