0000100010000000
0000110011000000
0000011011000000
0000001110000000
0000000110000000
0000000110000000
0000000110000000
0000001110000000
0000001110000000
0000001110000000
0000000110000000
0000011110000000
0000001110000000
0000011011100000
0000110000100000
0000100000110000
0001100000010000
