0000000000000000
0000000000000000
0000000111000000
0000001000100000
0000001000100000
0000000111000000
0011110001001110
0100101001001101
0110101000011001
0100100000001010
0111101000111110
0111111111111110
0000010101010000
0000010101110000
0000011101010000
0000111101111000
