0000000000000000
0011111111111000
0101110110001110
0111111111100100
0111110011111110
0111110001111010
0110011011010101
0011110000010111
0011011110011110
0010110000011111
0000010000010000
0000010000010000
0000010000010000
0000011111110000
1111111101111100
0011001000000111
