0000000001000000
0000000010000100
0000000110010000
0000001101100110
0000000010101100
0000011110111100
0000111111000010
0000101100110000
0000011001100000
0000010001000000
0000001010000000
0000001100000000
0000000000000000
0000000000000000
0000000000000000
0000000000000000
