0001111000000111
0011011110011100
0111111111110000
0101000001100000
0000011001100111
0000001111111100
0000000001100000
0101011111111011
0111111101101110
0011110001100000
0000000001100000
0000001101101110
0000011111111111
0000011101100110
0000000001100000
0000001111111000
