0000100100000000
0000100100000000
0000111100000000
0000011000000000
0000111100000000
0000111111000000
0000111101100000
0000011110110000
0011111111011000
0110001111101100
0110011011100100
0100111111110100
0000101001110000
0000101001000000
0001011001000000
0001010001000000
