0000000000000000
0000000000000000
0000000010000000
0001000010000000
0001001100000000
0001010001111100
0000101111000000
0000111111111100
0000111111111110
0000011111111100
0000001100101000
0000001001101100
0000011001000110
0000000001100000
0000000000000000
0000000000000000
