0000000000000000
0000001111100000
0000100000011000
0001000000001000
0000000111000100
0010001101000000
0010001100000010
0010001001000010
0010001011000010
0010001110000010
0111111111111111
0000000000000001
0100000000000001
0011000000000011
0000111111111100
0000000000000000