0000000000000000
0101000000000000
1111100000000000
0111000001111000
0111000111101100
1111101100000110
0111001001000010
0010011000000010
0010010000010010
0010010000010010
0111111000010010
0010001100000110
0010000111111100
0010000001001000
0010000001001000
0010000011011000
