0111000000000000
1000100000000000
0010100000000000
0000100001111000
0011000111101100
0010001100000110
0010001001000010
0010011000000010
0010010000010010
0010010000010010
0111111000010010
0010001100000110
0010000111111100
0010000001001000
0010000001001000
0010000011011000
