0000000000000000
0000000000000000
0000000000000000
0000000000000000
0000000000000000
0000000000000000
0000111111110000
0001100000011000
0011010000101100
0110000000000110
0100000110000010
0110000110000010
0011000000000110
0001111111111100
0000000000000000
0000000000000000
