0000011111000000
0000011111100000
0000011111100000
0000011111100000
0000001111000000
1111111111000000
0111111111000000
0000001111000000
0000001111000000
0000001111000000
0000011111000000
0000111011000000
0000110011000000
0001110011000000
0011100011000000
0011100011000000