0000000000000000
0000000000000000
0000111110000000
0001100011100000
0011000000110000
0110111111011000
1100010010001100
1000010010000100
1000000000000100
1100011110001100
0110001100011000
0011110001110110
0000011111001001
0000000000001001
0000000000000110
0000000000000000