0000000000000000
0000000110000000
0000001001000000
0100001001000000
0010000110000000
0001000110000000
0000111111000000
0000001001000000
0000001001000000
0000001001000000
0000000110000000
0000000110000000
0000000110000000
0000000110000000
0000000110000000
0000001111000000
