0000000000000000
0000000110000000
0000001001000000
0000001001000000
0001100110000000
0001101011000000
0001111111000000
0001101001000000
0000001001000000
0000001001000000
0000000110000000
0000000110000000
0000000110000000
0000000110000000
0000000110000000
0000001111000000
