0000000000000000
0000000111000000
0000001011000000
0000001011000000
0000000111100000
0001111111111100
0001001100110100
0001001100001100
0001111100001110
0001111100001110
0001111100010010
0000111111100010
0000001111100000
0000001101110000
0000001100110000
0000001101110000
