0000000000000000
0000000110000000
0000001111000000
0000001011000000
0000001011100000
0000011111110000
0000010101010000
0001111111010000
0000111111010000
0000011111110000
0000000101000000
0000000101000000
0000001101000000
0000001001000000
0000001111000000
0000011111000000
