0000000000000000
0000000000000000
0000000000000000
0000000000000000
0000000000000000
0000000000000000
0000111000000000
0001111111111111
0011100000010111
0110101001111011
1110011001111011
1101111111001011
1111111000011111
0001000000001010
0000100000000100
0000000000000000
